[
------------------------------------------------------------------------------------------------|
------------------------------------------------------------------------------------------------|
------------------------------------------------------------------------------------------------|
-                                                                                         ------|
-                                                                                         ------|
-                                                                                       + ------|
-=====*===============*==============*=================*======   =============*===========------|
--------------------------------------------------------------   -------------------------------|
---+                                                                         $------------------|
---              =          =                 =                        -------------------------|
---======       =-==========-========*========-=====*==================-------------------------|
-     -          -------------------------------------------------------------------------------|
-     -   =                  -------------------------------------------------------------------|
- P ==-===-                    -----------------------------------------------------------------|
-----------========*======== + -----------------------------------------------------------------|
------------------------------------------------------------------------------------------------|
------------------------------------------------------------------------------------------------|
------------------------------------------------------------------------------------------------|
------------------------------------------------------------------------------------------------|
------------------------------------------------------------------------------------------------|
]

player 100 100 

portal 235 380 160 380

witch 2208 320 left

/